[
-------------------|
-   ---- -  ----  -|
-             -   -|
-       - -       -|
-    - -   - -    -|
-    -E-- -- -    -|
-      -   -      -|
-      -- --      -|
-      -   -      -|
-      -  --     --|
-     W--  -      -|
-------------------|
]

player 256 128

monsterPursuer 320 320 1 0 333 1
/
player 64 288

monsterBat 32 96 1 0 111 4
monsterBat 64 160 1 0 111 3
monsterBat 32 224 1 0 111 5