[
--------|
-- -E E-|
-  -   -|
-  -   -|
-  -   -|
-  -   -|
-  -   -|
-  -   -|
-- - ---|
-     W-|
--------|
]

player 32 288


monsterPursuer 64 32 1 0 333 2
/
