[
--------|
-     E-|
- --   -|
-  -   -|
- --   -|
-  -   -|
- --   -|
-  -   -|
- -- ---|
-  -  W-|
--------|
]

player 32 288

monsterBat 128 288 0 1 111 2
/
