[
-----------|
-    E    -|
-         -|
-   -     -|
-   -   W -|
-   -     -|
-         -|
-  E      -|
-----------|
]

player 64 128


/
