[
-----------|
-         -|
-         -|
-----     -|
-   -   W -|
- -E-     -|
- -E-     -|
-  EEE    -|
-----------|
]

player 64 128


/
