[
-----------|
- E  -   W-|
-       ---|
- ---E   E-|
-   -     -|
- - -  -  -|
- - -  E  -|
-         -|
-----------|
]

player 64 128

/

-----------|
-    -E  W-|
-       ---|
----- E  E-|
-   -  E  -|
- - -  -  -|
- - -     -|
-         -|
-----------|

-----------|
-    -   W-|
-       ---|
- ---E    -|
-   -     -|
- - -  -  -|
- - -E E  -|
-   - E   -|
-----------|