[
---------------------|
-                   -|
-      E            -|
-    --      --     -|
-    --      --     -|
-               E   -|
-                   -|
-       --  E      --|
-   E   --     W   --|
-                   -|
---                 -|
---------------------|
]

player 32 32


/
