[
-----------|
-  -     W-|
-  E    ---|
- ---    E-|
-   -     -|
-E- -  -  -|
- - -    E-|
-  E      -|
-----------|
]

player 64 128


/
