[
-----------|
-        W-|
-  -    ---|
---- -    -|
-    -    -|
- -- -  - -|
- E       -|
-         -|
-----------|

]

player 64 128



/
monsterBat 32 64 1 0 1
-----------|
-    -E  W-|
-       ---|
----- E  E-|
-   -  E  -|
- - -  -  -|
- - -     -|
-         -|
-----------|

monsterWraith 64 64 0 1 1
monsterBat 32 224 1 0 1
