[
------------|
-     -    -|
-     -    -|
-          -|
-     -    -|
-     -    -|
--- ----   -|
-     -E   -|
-          -|
-          -|
-         W-|
------------|
]

player 32 32

monsterBat 224 128 0 1 5
monsterBat 32 224 1 0 5

/
