[
-----------|
-   -     -|
--  -  -  -|
-   - E-  -|
-  --- -- -|
-      -  -|
-W-- ---  -|
---   -   -|
- -   -- --|
-         -|
-----------|
]

player 32 32


/
