[
-----------|
-   -     -|
--  -  -  -|
-   -  -  -|
-  --- -- -|
-      -  -|
-W-- ---  -|
---E  -   -|
---   --  -|
-         -|
-----------|
]

player 32 32


/
