[
-----------|
-   -     -|
--  - E-  -|
- E -  -  -|
-  --- -- -|
-      -  -|
-W-- ---  -|
---   -   -|
- -   -- --|
- E   EE  -|
-----------|
]

player 32 32


/
