[
----------------|
-  E-    -E    -|
--  - E     E  -|
- E         -- -|
-  --- --      -|
- E    E-  -  E-|
-W--      E    -|
---   - -  E -E-|
-   E  -      --|
- E    E     E -|
----------------|
]

player 32 32


/
