[
-----------------|
-----------------|
--      -     E--|
-- *     E     --|
--   -      -  --|
-- E     -E *  --|
-- -@  E   @-  --|
--  E          --|
--  ---  -E-  ---|
--     E ---- *--|
--       -W    --|
--   -    -  - --|
--  E@ -    E  --|
-----------------|
-----------------|
]

player 160 64

monsterBat 192 192 1 0 111 3

monsterBat 256 320 0 1 111 4

monsterBird 320 128 1 0 222 3

monsterPursuer 96 320 1 0 333 1

monsterWraith 416 128 0 1 333 2

/
